date - дата, свидание
hump - горб
chalk - мел
sounds like - звучит как
totally - полностью
all of a sudden - внезапно, вдруг
It turns out - оказывается
weird - странный, странно
sweetie - милая, милый, дорогая, дорогой, конфетка
grab - схватить
intestine - кишки, кишечник
pull out - вытаскивать, вынимать
mouth - рот
tie - завязывать, связывать
neck - шея
aura - аура
murky - грязный, запачканный, темный
hell - ад
fixating - заострять внимание
say out loud - сказать вслух
pain - боль, душевная боль
angry - злой, оскорблён
hurting - обиженный
strip joint - стриптиз клуб
hammer - молоток, молот
decaf - кофе без кофеина
survivor - уцелевший, оставшийся в живых
wanna (want to) - хотеть
wet - мокрый
bridesmaid - подружка невесты, дружка
gravy boat - соусник
gorgeous - великолепный, прекрасный
turn on - вызывать интерес, переключатся
freak out - волновать, интересовать, возбуждать
it hit me - до меня дошло, меня осенило
familiar - Знакомый, близкий, похожий
anyway - так или иначе, во всяком случае, тем не менее
wondering - Задаваться вопросом, интересоваться
drift apart - разойтись
I was kind of hoping - Я надеялся
guess - предполагать
It matters - Это важно, это имеет значение
stairs - лестница
shoe - туфля, калоша
purse - кошелек, дамская сумочка, женская сумочка
hat - Шляпа, шапка
established - Установленный, учрежденный
breath - дыхание
calm - спокойный
probably - Вероятно, возможно
horrible - ужасный, противный
eyelash - ресница
What are you up? - Чем занимаешься?
supposed - предполагать, допускать, думать
honeymoon - медовый месяц
lizard - ящерица
furniture - мебель, обстановка, фурнитура
excited - взволнованный, напряженный
actually - на самом деле, действительно, в действительности, фактически
gonna (going to) - Собираться
gotta (got to) - нужно
hang out - прогуляться, тусоваться
The wine guy - Красавец, красавчик
